32 32
10 8
62 30 63 1 0 0 1 1 1 1
1 33 33 33 33 33 33 1 1 1
1 33 15 8 63 1 1 1 1 1
1 33 1 1 33 33 1 1 1 1
1 33 1 1 1 1 1 1 1 1
1 33 1 1 1 1 1 1 1 1
1 33 1 1 1 1 1 1 1 1
1 1 1 1 1 1 1 2 1 33